##############################
#                            #
#                            #
#                            #
#                            #
#                            #
#                            #
#                            #
#         #        #         #
#         #        #         #
#         #        #         #
#         #        #         #
#         #        #         #
#         #        #         #
#         #        #         #
#         #        #         #
#         #        #         #
#         #        #         #
#         #        #         #
#         #        #         #
#         #        #         #
#         #        #         #
#         #        #         #
#         #        #         #
#         #        #         #
#         #        #         #
#         #        #         #
#         #        #         #
#         #        #         #
#         #        #         #
#         #        #         #
#         #        #         #
#         #        #         #
#                            #
#                            #
#                            #
#                            #
#                            #
#                            #
#                            #
#                            #
##############################